####################
#..................#
#..####............#
#..................#
####################